12	12	12	12	12	12	12	12	12	12	12	12	12	12	12	12	12	12	12	12	12	12	12	12	12	12	12	12	12	12	12	12	12	12	12	12	12	12	12	12	12	12	12	12	12	12	12	12	12	12	12	12	12	12	12	12	12	12	12	12	12	12	12	12	12	12	12	12	12	12	12	12	12	12	12	12	12	12	12	12	12	12	12	12	12	12	12	12	12	12	12	12	12	12	12	12	12	12	12	12
12	12	13	12	12	12	12	13	12	12	12	12	13	12	12	12	12	13	12	12	12	12	13	12	12	12	12	13	12	12	12	12	13	12	12	12	12	13	12	12	12	12	13	12	12	12	12	13	12	12	12	12	13	12	12	12	12	13	12	12	12	12	13	12	12	12	12	13	12	12	12	12	13	12	12	12	12	13	12	12	12	12	13	12	12	12	12	13	12	12	12	12	13	12	12	12	12	13	12	12
12	12	12	13	12	12	12	12	13	12	12	12	12	13	12	12	12	12	13	12	12	12	12	13	12	12	12	12	13	12	12	12	12	13	12	12	12	12	13	12	12	12	12	13	12	12	12	12	13	12	12	12	12	13	12	12	12	12	13	12	12	12	12	13	12	12	12	12	13	12	12	12	12	13	12	12	12	12	13	12	12	12	12	13	12	12	12	12	13	12	12	12	12	13	12	12	12	12	13	12
12	12	12	12	13	12	12	12	12	13	12	12	12	12	13	12	12	12	12	13	12	12	12	12	13	12	12	12	12	13	12	12	12	12	13	12	12	12	12	13	12	12	12	12	13	12	12	12	12	13	12	12	12	12	13	12	12	12	12	13	12	12	12	12	13	12	12	12	12	13	12	12	12	12	13	12	12	12	12	13	12	12	12	12	13	12	12	12	12	13	12	12	12	12	13	12	12	12	12	12
12	12	12	12	12	13	12	12	12	12	13	12	12	12	12	13	12	12	12	12	13	12	12	12	12	13	12	12	12	12	13	12	12	12	12	13	12	12	13	12	13	12	12	12	12	13	12	12	12	12	13	12	12	12	12	13	12	12	12	12	13	12	12	12	12	13	12	12	12	12	13	12	12	12	12	13	12	12	12	12	13	12	12	12	12	13	12	12	12	12	13	12	12	12	12	13	12	12	12	12
12	12	12	12	12	12	12	12	12	12	12	12	12	12	12	12	12	12	12	12	12	12	12	12	12	12	12	12	12	12	12	12	12	12	12	12	12	12	12	12	12	12	12	12	12	12	12	12	12	12	12	12	12	12	12	12	12	12	12	12	12	12	12	12	12	12	12	12	12	12	12	12	12	12	12	12	12	12	12	12	12	12	12	12	12	12	12	12	12	12	12	12	12	12	12	12	12	12	12	12
12	12	12	12	12	12	12	12	12	12	12	12	12	12	12	12	12	12	12	12	12	12	12	12	12	12	12	12	12	13	12	12	12	12	13	12	12	12	12	12	12	12	12	12	12	12	12	12	12	12	12	12	12	12	12	12	12	12	12	12	12	12	12	12	12	12	12	12	12	12	12	12	12	12	12	12	12	12	12	12	12	12	12	12	12	12	12	12	12	12	12	12	12	12	12	12	12	12	12	12
12	12	13	12	12	12	12	12	22	20	20	20	20	20	20	23	12	12	12	12	12	12	12	12	12	12	12	12	12	12	12	12	12	12	12	12	12	13	12	12	12	12	12	12	12	12	12	12	12	12	12	12	12	22	20	20	20	20	20	20	20	20	20	20	20	20	20	20	20	20	20	20	20	20	20	20	20	20	20	20	20	20	20	20	20	20	20	23	12	12	12	12	12	12	12	13	12	12	12	12
12	12	12	12	12	12	12	12	18	10	10	11	10	10	10	20	20	20	20	20	20	20	20	20	23	12	12	12	12	12	22	20	20	20	20	20	20	20	20	20	20	20	20	20	20	23	12	12	12	12	12	13	13	18	41	41	41	41	41	41	41	41	41	41	41	41	41	41	41	41	10	10	41	41	41	11	10	10	10	10	10	10	10	10	10	10	10	17	12	12	12	12	13	12	12	12	12	12	12	12
12	12	12	12	12	13	12	22	21	10	10	10	10	10	10	10	10	10	10	10	10	10	10	10	20	20	20	20	20	20	20	10	10	10	10	10	10	10	10	10	41	41	41	41	41	17	12	13	12	12	12	12	12	18	41	41	41	41	41	41	41	41	41	41	41	41	41	41	41	41	10	41	10	10	10	41	10	10	10	10	10	10	10	10	10	10	10	17	13	12	12	12	12	12	12	12	12	12	13	12
12	12	12	12	12	12	12	18	10	10	10	10	10	10	11	10	10	10	10	10	10	11	10	10	10	10	10	10	11	10	10	10	10	10	10	10	10	10	10	35	33	33	33	33	36	17	12	12	13	12	12	12	12	18	41	41	41	41	41	41	41	41	41	41	41	41	41	41	41	41	11	41	10	41	10	41	10	10	10	40	40	40	40	40	40	40	10	17	12	13	12	12	12	12	12	12	12	12	12	12
12	12	12	12	12	12	12	18	10	10	11	10	10	10	10	10	10	10	11	10	10	10	10	10	10	10	11	10	10	10	10	10	11	10	10	10	10	10	10	31	26	26	26	26	30	17	12	12	12	13	12	12	12	18	41	41	41	41	41	41	41	41	41	41	41	41	41	41	41	41	10	41	10	10	41	41	10	10	10	40	52	52	52	52	52	40	10	17	12	12	13	12	12	12	12	12	12	12	12	12
12	12	13	12	12	12	12	18	10	10	10	10	10	10	10	10	10	10	10	10	10	10	10	10	10	10	10	10	10	10	10	10	10	10	10	11	10	10	10	31	26	26	26	26	30	17	12	12	12	12	12	12	12	18	41	41	41	41	41	41	41	41	41	41	41	41	41	41	41	41	10	41	10	10	10	41	11	10	10	40	52	52	52	52	52	40	11	17	12	12	12	12	12	12	12	13	12	12	12	12
12	12	12	13	12	12	12	18	41	10	10	10	11	10	10	10	10	10	10	10	10	10	10	10	10	11	10	10	10	11	10	10	10	10	10	10	10	10	10	31	26	27	28	28	38	17	12	12	12	12	12	12	12	18	41	41	41	41	41	41	41	41	41	41	41	41	41	41	41	41	10	41	10	10	10	41	10	10	10	40	52	52	52	52	52	40	10	17	12	12	13	12	12	12	12	12	13	12	12	12
12	12	12	12	13	12	12	21	41	10	10	10	10	10	10	11	10	10	10	10	10	10	10	10	10	10	10	10	10	10	10	10	10	10	10	10	11	10	10	31	26	30	14	15	15	25	12	12	12	12	12	12	22	21	41	41	41	41	41	41	41	41	41	41	41	41	41	41	41	41	10	41	10	11	10	41	10	10	10	40	52	52	52	52	52	40	10	17	12	12	12	13	12	12	12	12	12	13	12	12
12	12	12	12	12	13	18	41	41	10	10	10	10	10	10	10	10	10	10	10	10	10	10	11	10	10	10	11	10	10	10	10	10	10	10	10	11	10	10	31	26	30	17	12	12	12	12	12	12	12	12	12	18	41	41	41	41	41	41	41	41	41	41	41	41	41	41	41	41	41	10	41	10	10	10	41	10	10	10	40	52	52	52	52	52	40	10	17	12	12	12	12	12	12	12	12	12	12	13	12
12	12	12	12	12	12	18	41	41	11	10	10	10	10	10	10	10	10	11	10	10	10	10	10	10	10	10	10	10	11	10	10	10	10	10	10	10	10	11	31	26	30	17	12	12	12	12	12	12	12	12	13	18	41	41	41	41	41	41	41	41	41	41	41	41	41	41	41	41	41	10	10	10	10	10	10	10	10	10	40	52	52	52	52	52	40	10	19	20	20	20	20	20	23	12	12	12	12	12	12
12	12	12	12	12	12	18	41	41	33	33	33	33	33	33	33	33	33	33	33	33	33	33	33	33	33	33	33	33	33	33	33	33	33	33	33	33	33	33	34	26	30	17	12	12	12	12	13	12	12	12	12	18	41	41	41	41	41	41	41	41	41	41	41	41	41	41	41	41	41	10	10	11	10	10	10	10	11	10	40	52	52	52	52	52	40	10	41	41	41	41	41	10	17	12	12	12	12	12	12
12	13	12	12	12	12	18	41	41	26	26	26	26	26	26	26	26	26	26	26	26	26	26	26	26	26	26	26	26	26	26	26	26	26	26	26	26	26	26	26	26	30	17	12	12	12	12	12	13	12	12	12	18	41	41	41	41	41	41	41	41	41	41	41	41	41	41	41	41	41	10	10	10	10	41	10	10	10	10	40	52	52	52	52	52	40	10	41	41	41	41	41	10	17	13	12	12	12	12	12
12	12	12	12	13	12	24	16	41	28	28	28	28	28	28	28	28	28	28	28	28	28	28	29	26	27	28	28	28	28	28	28	28	28	28	28	28	28	28	28	28	35	17	23	12	23	12	12	12	13	12	12	18	11	10	10	10	41	41	41	41	41	41	41	41	41	41	41	41	41	10	11	10	10	10	10	10	10	10	40	52	52	52	52	52	40	10	41	41	41	41	41	10	17	12	12	12	13	12	12
12	13	12	12	12	12	12	18	41	10	10	10	10	10	10	10	10	10	10	10	10	10	10	31	26	30	10	10	10	10	10	10	10	10	10	10	10	10	10	10	10	10	10	20	20	17	12	12	12	12	12	12	18	10	10	10	10	41	41	41	41	41	41	41	41	41	41	41	41	41	10	10	41	10	10	41	10	10	10	40	52	52	52	52	52	40	10	41	41	41	41	41	10	17	13	12	12	12	12	12
12	12	12	12	12	12	12	18	41	10	10	10	10	10	10	10	10	10	10	10	10	10	10	31	26	30	10	10	10	10	10	10	10	11	10	10	10	10	10	10	11	10	10	10	10	17	12	12	12	12	12	12	18	10	10	11	10	41	41	41	41	41	41	41	41	41	41	41	41	41	10	10	10	10	10	10	10	10	10	40	52	52	52	52	52	40	11	10	10	10	10	10	10	17	12	12	12	12	12	12
12	12	12	12	12	12	12	18	10	10	10	10	10	10	10	10	10	10	10	10	10	10	10	31	26	30	10	10	10	11	10	10	10	10	10	10	10	10	10	10	10	10	10	10	10	17	12	12	12	12	12	12	18	10	10	10	10	41	41	41	41	41	41	41	41	41	41	41	41	41	11	10	10	11	10	10	10	11	10	40	52	52	52	52	52	40	10	10	10	10	10	10	10	17	12	12	12	12	12	12
12	12	12	12	12	12	12	18	10	10	10	10	10	10	10	10	10	10	10	10	10	10	10	31	26	30	10	10	10	10	10	10	10	10	10	10	10	11	10	10	10	10	10	10	10	17	12	12	12	12	12	12	18	10	10	10	10	10	10	10	10	10	10	10	10	10	10	10	10	10	10	10	10	10	10	10	10	10	10	40	40	40	10	40	40	40	10	14	15	15	15	16	10	17	12	12	12	12	12	12
12	13	12	12	12	12	12	24	16	41	41	41	41	41	41	41	41	41	41	41	41	41	10	31	26	30	11	10	10	10	10	10	10	10	10	10	10	10	10	10	10	10	11	11	10	17	12	12	12	12	12	13	18	10	10	10	10	33	33	33	33	33	33	33	33	33	33	33	33	33	33	33	34	26	32	33	33	33	33	33	33	34	26	32	33	10	10	17	12	12	12	18	10	17	13	12	12	12	12	12
12	12	13	12	12	12	12	12	18	41	41	41	41	41	41	41	41	41	41	41	41	41	11	31	26	30	10	10	10	11	10	10	10	10	10	10	11	10	10	10	10	10	10	10	10	17	12	13	12	12	12	12	18	10	10	10	10	26	26	26	26	26	26	26	26	26	26	26	26	26	26	26	26	26	26	26	26	26	26	26	26	26	26	26	26	10	10	17	12	12	12	18	10	17	12	13	12	12	12	12
12	12	12	13	12	12	12	12	18	41	41	41	41	41	41	41	41	41	41	41	41	41	10	31	26	30	10	10	10	10	10	10	10	11	10	10	10	10	10	10	10	10	10	10	10	17	12	12	13	12	12	12	18	10	10	10	10	28	28	28	28	28	28	28	28	28	28	29	26	27	28	28	28	28	28	28	28	28	28	28	28	28	28	28	28	10	10	17	12	12	12	18	10	17	12	12	13	12	12	12
12	12	12	12	13	12	12	12	18	41	41	41	41	41	41	41	41	41	41	41	41	41	10	31	26	30	10	41	41	41	41	41	41	41	41	41	41	41	41	41	41	41	41	41	41	17	12	12	12	13	12	12	18	10	10	10	11	10	10	10	10	10	10	10	10	10	10	31	26	30	10	41	41	41	41	41	41	41	41	41	10	10	41	10	10	10	10	17	12	12	12	18	10	17	12	12	12	13	12	12
12	12	12	12	12	13	12	12	18	41	41	41	41	41	41	41	41	41	41	41	41	41	10	31	26	30	10	41	41	41	41	41	41	41	41	41	41	41	41	41	41	41	41	41	41	17	12	12	12	12	12	12	18	10	10	10	10	41	41	41	41	41	41	41	41	41	41	31	26	30	10	41	41	41	41	41	41	41	41	41	10	10	10	10	10	10	10	17	12	12	12	18	10	17	12	12	12	12	13	12
12	12	12	12	12	12	12	12	18	15	15	15	15	15	15	15	16	41	41	41	41	41	10	31	26	30	10	41	41	41	41	41	41	41	41	41	41	41	41	41	41	41	41	41	41	17	12	12	12	12	12	12	18	10	11	10	10	41	41	41	41	41	41	41	41	41	41	31	26	30	10	41	41	41	41	41	41	41	41	41	10	10	10	41	10	10	10	17	12	12	12	18	10	17	12	12	12	12	12	12
12	12	12	12	12	12	12	12	24	12	12	12	12	12	12	12	24	15	15	15	16	41	10	31	26	30	10	41	41	14	15	15	15	15	15	15	15	15	15	15	15	15	15	15	15	25	12	12	12	12	12	12	18	41	41	41	41	41	41	41	41	41	41	41	41	41	41	31	26	30	10	41	41	41	41	41	41	41	41	41	10	10	10	10	10	10	10	17	12	12	12	18	10	17	12	12	12	12	12	12
12	12	12	12	12	12	12	12	12	12	12	12	12	12	12	12	12	12	12	12	18	41	41	31	26	30	10	41	41	17	12	12	12	13	12	12	12	12	13	12	12	12	12	12	12	12	12	12	12	12	12	12	18	41	41	41	41	41	41	41	41	41	41	41	41	41	41	31	26	30	10	41	41	41	41	41	41	41	41	41	10	10	10	10	10	10	10	17	12	12	12	18	10	17	12	12	12	12	12	12
12	12	13	12	12	12	12	12	12	12	12	12	12	12	12	12	12	12	12	12	24	15	15	15	15	15	15	15	15	25	12	12	12	12	12	12	12	12	12	12	12	12	13	12	12	12	12	12	12	12	12	13	18	41	41	41	41	41	41	41	41	41	41	41	41	41	41	31	26	30	10	41	41	41	41	41	41	41	41	41	10	41	10	10	41	10	10	17	12	12	12	18	10	17	12	13	12	12	12	12
12	12	12	13	12	12	12	12	12	12	12	12	12	12	12	12	12	12	12	12	12	12	12	12	12	12	12	12	12	12	12	12	12	12	12	13	12	12	13	12	12	12	12	12	13	12	12	13	12	12	12	12	18	41	41	41	41	41	41	41	41	41	41	41	41	41	41	31	26	30	10	41	41	41	41	41	41	41	41	41	10	10	10	10	10	10	10	17	12	12	12	18	10	17	12	12	13	12	12	12
12	12	12	12	13	12	12	12	12	12	12	12	12	12	12	12	12	12	12	12	12	12	12	12	12	12	12	12	12	12	12	12	12	12	12	12	12	12	12	13	12	12	12	12	12	12	12	12	13	12	12	12	24	16	41	41	41	41	41	41	41	41	41	41	41	41	41	31	26	30	10	41	41	41	41	41	41	41	41	41	10	10	10	10	10	10	10	17	12	12	12	18	10	17	12	12	12	13	12	12
12	12	12	12	12	13	12	12	12	12	12	13	12	12	12	12	12	13	12	12	12	12	12	13	12	12	12	12	12	13	12	12	12	12	12	13	12	12	12	12	13	12	12	12	13	12	12	12	12	13	12	12	12	18	41	41	41	41	41	41	41	41	41	41	41	41	41	31	26	30	10	41	41	41	41	41	41	41	41	41	10	10	10	10	10	10	10	19	20	20	20	21	10	17	12	12	12	12	13	12
0	12	12	12	12	12	12	12	12	12	12	12	12	12	12	12	12	12	12	12	12	12	12	12	12	12	12	12	12	12	12	12	12	12	12	12	12	12	12	12	12	12	12	12	12	12	12	12	12	12	12	12	12	18	41	41	41	41	41	41	41	41	41	41	41	41	41	31	26	30	10	41	41	41	41	41	41	41	41	41	10	10	10	41	10	10	10	10	10	10	10	10	10	17	12	12	12	12	12	12
12	12	12	12	12	12	12	12	12	12	12	12	12	12	12	12	12	12	12	12	12	12	12	12	12	12	12	12	12	12	12	12	12	12	12	12	12	12	12	12	12	12	12	12	12	12	12	12	12	12	12	12	12	18	41	41	41	41	41	41	41	41	41	41	41	41	41	31	26	30	10	41	41	41	41	41	41	41	41	41	10	10	10	10	10	10	10	10	10	10	10	10	10	17	12	12	12	12	12	12
12	12	13	12	12	12	12	12	12	12	12	12	12	12	12	12	12	12	12	12	12	12	12	12	12	12	12	12	12	12	12	12	12	12	12	12	12	12	13	12	12	12	12	12	12	12	12	13	12	12	12	12	12	18	41	41	41	41	41	41	41	41	41	41	41	41	41	31	26	30	10	41	41	41	41	41	41	41	41	41	10	41	10	10	41	10	10	41	41	41	41	41	10	17	12	13	12	12	12	12
12	12	12	12	12	12	12	12	12	12	13	12	12	12	12	12	12	22	20	20	20	20	20	20	20	20	20	20	20	20	20	20	23	12	12	13	12	12	12	12	13	12	12	12	13	12	12	12	12	13	12	12	12	18	41	41	41	41	41	41	41	41	41	41	41	41	41	31	26	30	10	41	41	41	41	41	41	41	41	41	10	10	10	10	10	10	10	41	41	41	41	41	10	17	12	12	12	12	12	12
12	12	12	12	12	13	12	12	12	12	22	20	20	20	20	20	20	21	10	10	10	10	10	10	10	10	10	10	10	10	10	10	17	12	12	12	13	12	12	13	12	12	13	12	12	13	12	12	13	12	12	13	13	18	41	41	41	41	41	41	41	41	41	41	41	41	41	10	10	10	10	41	41	41	41	41	41	10	10	10	10	10	10	10	10	10	10	41	41	41	41	41	41	17	12	12	12	12	13	12
12	12	12	12	12	12	12	12	12	12	18	41	41	41	41	10	10	10	10	41	41	41	10	10	10	10	10	10	10	41	41	41	19	20	20	20	23	12	12	12	12	12	12	12	12	12	12	13	12	12	12	12	12	24	15	15	15	15	15	16	10	10	40	40	40	40	40	40	10	40	40	40	40	40	40	41	41	10	10	10	41	10	10	41	10	10	10	41	41	41	41	41	41	17	12	12	12	12	12	12
12	12	12	12	12	12	12	13	12	13	18	41	41	41	41	10	10	10	10	41	41	41	10	10	41	10	10	10	10	41	41	41	41	41	41	41	19	20	20	20	20	20	20	20	20	20	20	20	20	20	20	23	12	12	12	12	12	13	13	18	10	10	40	10	10	10	10	10	10	40	41	41	41	41	40	10	14	15	15	15	15	15	15	15	15	15	15	15	15	15	15	15	15	25	12	12	12	12	12	12
12	12	13	12	12	12	12	12	12	12	18	41	41	41	41	10	10	11	10	41	41	41	10	10	10	10	10	10	10	41	41	41	41	41	41	41	41	41	41	41	41	41	41	41	41	41	41	41	41	41	41	17	12	13	12	12	12	12	12	18	10	10	40	10	40	40	40	40	40	40	41	41	41	41	40	10	17	13	12	12	12	12	13	12	12	12	12	13	12	12	12	12	12	12	12	13	12	12	12	12
12	12	12	13	12	12	12	12	13	12	18	41	41	41	41	10	10	10	10	41	41	41	10	10	10	10	10	41	41	41	41	41	41	41	41	41	41	41	41	41	41	41	41	41	10	41	41	41	41	41	41	17	12	12	13	12	12	12	12	18	10	10	40	10	40	41	41	41	41	41	41	41	41	41	40	10	17	12	13	12	12	12	13	12	12	12	12	13	12	12	12	12	12	12	12	12	13	12	12	12
12	12	12	12	13	12	12	12	12	12	18	41	41	41	41	10	10	10	10	41	41	41	10	10	41	11	10	11	11	41	41	41	41	41	41	41	41	41	41	41	41	41	41	41	10	41	41	41	41	41	41	17	12	12	12	13	12	12	12	18	10	10	40	10	40	41	10	10	10	41	41	41	41	41	40	10	17	12	12	12	12	12	13	12	12	12	12	13	12	12	12	12	12	12	12	12	12	13	12	12
12	12	12	12	12	13	12	12	22	20	21	41	41	41	41	10	10	10	10	41	41	41	10	10	10	10	10	10	10	41	41	41	41	41	41	41	41	41	41	41	41	41	41	41	10	10	10	10	41	41	41	17	12	12	12	12	12	12	12	18	10	10	40	10	40	41	10	10	10	41	41	41	41	41	40	10	17	12	13	12	12	12	13	12	12	12	12	13	12	12	12	12	12	12	12	12	12	12	13	12
12	12	12	12	12	12	12	22	21	10	10	10	10	10	10	10	10	10	10	10	41	41	10	11	10	10	10	10	10	41	41	41	41	41	41	41	41	41	41	41	41	41	41	41	10	10	10	10	41	41	41	17	12	12	12	12	12	12	12	18	10	10	40	10	40	41	10	11	11	41	41	41	41	41	40	10	17	12	12	13	12	12	13	12	12	12	12	13	12	12	12	12	12	12	12	12	12	12	12	12
12	12	12	12	12	12	12	18	10	10	10	10	10	10	10	10	10	10	11	10	10	41	10	10	10	10	10	10	10	41	41	41	41	41	41	41	41	41	41	41	41	41	41	41	10	11	10	10	10	10	10	17	12	12	12	12	12	12	12	18	10	10	40	10	40	41	10	10	10	41	41	41	41	41	40	10	17	12	12	12	13	12	13	12	12	12	12	13	12	12	12	12	12	12	12	12	12	12	12	12
12	13	12	12	12	12	12	18	10	10	10	10	10	10	10	11	41	41	41	41	41	41	41	41	10	10	10	1	41	41	41	41	41	41	41	41	10	10	10	10	11	10	10	10	10	10	10	10	10	10	10	17	12	12	12	12	12	12	12	18	10	10	40	10	40	41	10	10	10	41	41	41	41	41	40	10	17	12	12	12	12	12	12	12	22	20	20	20	20	20	23	12	13	12	13	12	12	12	12	12
12	12	12	12	13	12	12	18	10	10	10	11	10	10	10	10	41	41	41	41	41	41	41	41	10	10	10	41	41	41	41	41	41	41	41	35	33	33	33	33	33	33	33	33	10	10	10	10	10	11	10	17	12	12	12	12	12	13	13	18	10	10	40	10	40	41	10	10	10	41	41	41	41	41	40	10	17	12	12	12	12	12	12	20	21	11	10	10	10	10	19	20	12	12	12	12	12	13	12	12
12	13	12	12	12	12	13	18	10	10	10	10	10	10	10	10	41	41	41	41	41	41	41	41	31	26	30	41	41	41	41	41	41	41	41	31	26	26	26	26	26	26	26	26	10	10	10	10	10	10	10	17	12	13	12	12	12	12	12	18	10	10	40	10	40	41	10	10	10	41	41	41	41	41	40	10	17	12	12	12	12	12	18	10	10	10	10	10	10	11	10	10	17	12	13	12	12	12	12	12
12	12	12	12	12	12	12	18	10	10	10	10	10	10	10	10	41	41	41	41	41	41	41	41	31	26	30	41	41	41	41	41	41	41	41	31	26	27	28	28	28	28	28	28	10	10	10	10	10	10	10	17	12	12	13	12	12	12	12	18	10	10	40	10	40	41	10	10	10	41	41	41	41	41	40	10	17	12	12	12	12	12	18	10	10	10	10	10	10	10	10	10	17	12	12	12	12	12	12	12
12	12	12	12	12	12	12	18	10	14	15	15	15	16	10	10	41	41	41	41	41	41	41	41	31	26	30	41	41	41	41	41	41	41	41	31	26	30	10	10	10	10	10	11	10	10	10	10	10	10	10	17	12	12	12	13	12	12	12	18	10	10	40	10	40	41	10	10	10	41	41	41	41	41	40	10	17	12	13	12	12	12	18	10	10	10	31	26	30	10	10	10	17	12	12	12	12	12	12	12
12	12	12	12	12	12	12	18	10	17	12	12	12	18	10	10	41	41	41	41	41	41	41	41	31	26	30	41	41	41	41	41	41	41	41	31	26	30	10	10	10	10	10	10	10	10	10	10	10	10	10	17	12	12	12	12	12	12	12	18	10	10	40	10	40	41	11	10	11	41	41	41	41	41	40	10	17	13	12	12	12	12	18	10	10	10	31	26	30	10	10	10	17	12	12	12	12	12	12	12
12	13	12	12	12	12	12	18	10	17	12	12	12	18	10	10	41	41	41	41	41	41	41	41	31	26	30	41	41	41	41	41	41	41	41	31	26	30	10	41	41	41	41	41	10	10	10	10	41	41	41	17	12	12	12	12	12	12	12	18	10	10	40	10	40	41	10	10	10	41	41	41	41	41	40	10	17	12	13	12	12	12	18	10	10	10	31	26	30	10	10	10	17	12	13	12	12	12	12	12
12	12	13	12	12	12	12	18	10	17	12	12	12	18	10	10	41	41	41	41	41	41	41	41	31	26	30	41	41	41	41	41	41	41	41	31	26	30	10	41	41	41	41	41	10	11	10	10	41	41	41	17	12	12	13	12	12	12	12	18	10	10	40	10	40	41	10	10	10	41	41	41	41	41	40	10	17	12	12	12	12	12	18	10	10	10	31	26	30	10	10	40	17	12	12	13	12	12	12	12
12	12	12	13	12	12	12	18	10	17	12	12	12	18	10	10	10	10	10	10	10	10	10	41	31	26	30	41	41	41	41	41	41	41	41	31	26	30	10	41	41	41	41	41	10	10	10	10	41	41	41	17	12	12	12	12	12	12	12	18	10	10	40	10	40	41	41	10	41	41	41	41	41	41	40	10	17	12	13	12	12	12	18	10	35	33	34	26	32	33	36	10	17	12	12	12	13	12	12	12
12	12	12	12	13	12	13	18	10	17	12	12	12	18	10	10	33	33	33	33	33	33	33	33	34	26	32	33	33	33	33	33	33	33	33	34	26	30	11	41	41	41	41	41	10	10	10	10	41	41	41	17	12	12	12	13	12	13	13	18	10	10	40	10	40	40	40	10	40	40	10	10	10	10	40	10	17	12	12	13	12	12	18	10	31	26	26	26	26	26	30	10	17	12	12	12	12	13	12	12
12	12	12	12	12	13	12	18	10	17	12	12	12	18	10	10	26	26	26	26	26	26	26	26	26	26	26	26	26	26	26	26	26	26	26	26	26	30	10	41	41	41	41	41	10	41	41	41	41	41	41	17	12	13	12	12	12	12	12	18	10	10	40	10	10	10	10	10	10	40	10	10	10	41	40	10	17	12	12	12	13	12	18	10	31	26	26	26	26	26	30	10	17	12	12	12	12	12	13	12
12	12	12	12	12	12	12	18	10	17	12	12	12	18	10	10	28	28	28	28	28	28	28	28	29	26	27	28	28	28	28	28	28	28	28	29	26	30	10	41	41	41	41	41	10	41	41	41	41	41	41	17	12	12	13	12	12	12	12	12	16	10	40	40	40	40	40	40	10	40	10	10	10	10	40	10	17	12	12	12	12	12	18	10	31	26	26	26	26	26	30	10	17	12	12	12	12	12	12	12
12	12	12	12	12	12	12	18	10	17	12	12	12	18	10	10	41	41	41	41	41	41	41	41	31	26	30	10	10	10	10	10	11	10	10	31	26	30	10	41	41	41	41	41	10	41	41	41	41	41	41	17	12	12	12	13	12	12	12	12	18	10	40	10	10	10	41	40	10	40	10	10	10	10	40	10	17	12	12	12	12	12	18	10	31	26	26	26	26	26	30	10	17	12	12	12	12	12	12	12
12	12	12	12	12	12	12	18	10	17	12	12	12	18	10	10	41	41	41	41	41	41	41	41	31	26	30	10	11	10	10	10	10	10	10	31	26	30	10	41	41	41	41	41	10	41	41	41	41	10	10	17	12	12	12	12	12	12	12	12	18	10	40	10	10	10	10	40	41	40	10	41	10	10	40	10	17	12	12	12	12	12	18	10	31	26	26	26	26	26	30	11	17	12	12	12	12	12	12	12
12	12	13	12	12	12	13	18	10	17	12	12	12	18	10	10	41	41	41	41	41	41	41	41	31	26	30	10	10	10	10	10	10	10	10	31	26	30	10	41	41	41	41	41	10	41	41	41	41	14	15	25	12	12	12	12	12	12	12	12	18	10	40	10	41	10	10	40	10	40	10	10	10	10	40	10	17	12	12	12	12	12	18	10	31	26	26	26	26	26	30	10	17	12	12	13	12	12	12	12
12	12	12	13	12	12	12	18	10	17	12	12	12	18	10	10	41	41	41	41	41	41	41	41	31	26	30	10	10	10	10	10	10	10	10	31	26	30	10	41	41	41	41	41	41	41	41	41	41	17	12	12	12	12	12	12	12	12	12	12	18	10	40	10	10	10	10	40	10	40	10	10	10	10	40	10	17	12	12	12	12	12	18	10	31	26	26	26	26	26	30	10	17	12	12	12	13	12	12	12
12	12	12	12	13	12	12	18	10	19	20	20	20	21	11	10	41	41	41	41	41	41	41	41	31	26	30	10	10	10	11	10	10	10	10	31	26	30	10	41	41	41	41	41	41	41	41	41	41	17	12	12	13	12	12	12	12	12	12	12	18	10	40	10	10	10	10	40	10	40	10	10	10	10	40	10	17	13	12	12	12	12	18	10	31	26	26	26	26	26	30	10	17	12	12	12	12	13	12	12
12	12	12	12	12	13	12	18	10	10	10	10	10	10	10	10	41	41	41	41	41	41	41	41	31	26	30	10	10	10	10	10	10	10	10	31	26	30	10	41	41	41	41	41	41	41	41	41	41	17	12	12	12	12	12	13	12	13	13	13	18	10	40	10	10	10	10	40	10	40	10	10	10	41	40	10	17	12	12	12	12	12	24	16	37	28	28	28	28	28	38	10	17	12	12	12	12	12	13	12
12	12	12	12	12	12	13	18	11	10	10	10	10	10	10	10	41	41	41	41	41	41	41	41	31	26	30	10	10	10	10	10	10	10	10	31	26	30	10	41	41	41	41	41	41	41	41	41	41	17	12	12	12	13	12	12	12	12	12	12	18	10	40	10	10	10	41	40	10	40	10	10	10	10	40	10	17	12	12	12	12	12	12	18	10	11	10	10	10	10	10	10	17	12	12	12	12	12	12	12
12	12	12	12	12	12	12	18	10	10	10	10	10	10	10	10	41	41	41	41	41	41	41	41	31	26	30	11	10	10	10	10	10	10	11	31	26	30	10	10	10	10	10	10	41	41	41	41	41	17	12	12	12	12	13	12	12	12	12	12	18	10	40	41	10	10	10	40	10	40	10	10	10	10	40	10	17	13	12	12	12	12	12	18	41	10	10	10	10	10	10	10	17	12	12	12	12	12	12	12
12	12	13	12	12	12	13	18	10	10	10	11	10	10	10	10	41	41	41	41	41	41	41	41	31	26	30	10	10	10	10	35	33	33	33	34	26	32	33	33	33	36	41	41	41	41	41	41	41	17	12	12	12	12	12	13	12	12	12	12	18	10	40	10	10	10	10	40	10	40	10	41	10	10	40	10	17	12	13	12	12	12	12	18	41	10	10	10	10	10	10	10	17	12	12	13	12	12	12	12
12	12	12	12	12	12	12	18	10	10	10	10	10	10	10	10	10	10	10	10	10	10	10	10	31	26	30	10	10	10	10	31	26	26	26	26	26	26	26	26	26	30	41	41	41	41	41	41	41	17	12	12	12	12	12	12	12	12	12	12	18	10	40	10	10	10	10	40	10	40	10	10	10	10	40	10	17	12	12	13	12	12	12	18	41	41	41	41	10	10	10	10	17	12	12	12	12	12	12	12
12	12	12	12	12	13	12	18	10	10	10	10	10	10	10	10	10	41	10	10	41	10	10	10	31	26	30	41	10	41	10	31	26	26	26	26	26	26	26	26	26	30	41	41	41	41	41	41	41	17	12	12	12	12	12	12	12	12	12	12	18	10	40	40	40	40	40	40	10	40	40	40	40	40	40	10	17	12	12	12	13	12	12	24	15	15	16	41	10	10	10	10	17	12	12	12	12	12	13	12
12	12	12	12	12	12	12	18	10	10	10	10	10	10	10	10	10	10	10	10	10	10	41	10	31	26	30	10	10	10	10	31	26	26	26	26	26	26	26	26	26	30	41	41	41	41	41	41	41	17	12	12	12	13	12	12	12	12	12	12	21	10	40	39	39	39	39	39	39	39	39	39	39	39	40	14	12	13	12	12	12	12	13	12	12	12	18	41	10	10	10	10	17	12	12	12	12	12	12	12
12	12	12	12	12	12	12	18	10	10	10	10	10	10	10	10	10	10	10	41	10	10	10	10	31	26	30	10	10	10	10	31	26	26	26	26	26	26	26	26	26	30	41	41	41	41	41	41	41	17	12	12	12	12	12	13	12	12	12	18	10	10	40	39	39	39	39	39	39	39	39	39	39	39	40	17	12	12	13	12	12	12	13	12	12	12	18	41	10	10	10	10	17	12	12	12	12	12	12	12
12	12	13	12	12	12	12	18	10	10	10	10	10	10	10	10	10	10	10	10	10	10	10	10	10	10	10	10	10	41	10	31	26	26	26	26	26	26	26	26	26	30	41	41	41	41	41	41	41	17	12	12	12	12	13	12	12	13	12	18	10	10	40	39	39	39	39	39	39	39	39	39	39	39	40	17	12	12	12	12	12	12	13	12	12	12	18	41	41	41	41	41	17	12	12	13	12	12	12	12
12	12	12	13	12	12	12	18	10	10	10	10	10	10	10	10	41	10	10	10	10	41	10	10	10	10	10	41	10	10	10	31	26	26	26	26	26	26	26	26	26	30	41	41	41	41	41	41	41	17	12	12	12	13	12	12	12	12	12	18	10	10	40	39	39	39	39	39	39	39	39	39	39	39	40	17	12	12	13	12	12	12	12	12	12	12	24	15	16	41	41	41	17	12	12	12	13	12	12	12
12	12	12	12	13	12	12	24	16	10	10	10	10	10	10	10	10	10	41	10	10	10	10	10	10	10	10	10	10	10	10	31	26	26	26	26	26	26	26	26	26	30	41	41	41	41	41	41	41	17	12	12	12	12	12	13	12	12	12	18	10	10	40	39	39	39	39	39	39	39	39	39	39	39	40	17	12	12	12	13	12	12	12	12	13	12	12	12	18	41	41	41	17	12	12	12	12	13	12	12
12	12	12	12	12	13	12	12	24	15	16	41	41	41	41	41	10	10	10	10	10	10	10	10	10	10	10	10	41	10	10	31	26	26	26	26	26	26	26	26	26	30	41	41	41	41	41	41	41	17	12	12	12	12	13	12	12	13	12	18	10	10	40	39	39	39	39	39	39	39	39	39	39	39	40	17	12	12	12	12	13	12	12	12	12	13	12	12	18	41	41	41	17	12	12	12	12	12	13	12
12	12	12	12	12	12	12	12	12	12	18	41	41	41	41	41	41	10	10	10	10	10	10	10	10	10	10	10	10	10	41	31	26	26	26	26	26	26	26	26	26	30	41	41	41	41	41	41	41	17	12	12	12	13	12	12	12	12	12	18	10	10	40	39	39	39	39	39	39	39	39	39	39	39	40	17	12	12	12	12	12	12	12	12	12	12	13	12	18	41	41	41	17	12	12	12	12	12	12	12
12	12	12	12	12	12	13	12	12	12	18	41	41	41	41	41	10	10	10	10	41	10	10	10	10	10	10	10	10	10	10	31	26	26	26	26	26	26	26	26	26	30	41	41	41	41	41	41	41	17	12	12	12	12	12	13	12	12	12	18	10	10	40	39	39	39	39	39	39	39	39	39	39	39	40	17	12	12	12	12	12	12	12	12	12	12	12	12	18	41	41	41	17	12	12	12	12	12	12	12
12	13	12	12	12	12	12	13	12	12	18	41	41	41	41	41	41	17	15	15	15	15	15	16	10	10	41	10	10	10	10	31	26	26	26	26	26	26	26	26	26	30	41	41	41	41	41	41	41	17	12	12	12	12	13	12	12	13	12	18	10	10	40	39	39	39	39	39	39	39	39	39	39	39	40	17	12	12	12	12	12	12	12	12	12	12	12	12	24	15	15	15	25	12	13	12	12	12	12	12
12	12	12	12	13	12	12	12	13	12	18	41	41	41	41	14	15	25	12	12	12	13	12	24	15	16	10	10	10	41	10	37	28	28	28	28	28	28	28	28	28	38	41	41	41	41	41	41	41	17	12	12	12	13	12	12	12	12	12	18	10	10	40	40	40	40	40	40	40	40	40	40	40	40	40	17	12	12	12	12	12	12	13	12	12	12	12	13	12	12	12	12	12	12	12	12	12	13	12	12
12	13	12	12	12	12	12	12	12	12	18	41	41	41	41	17	12	12	12	12	13	12	12	12	12	18	10	10	10	10	10	41	41	41	41	41	41	41	41	41	41	41	41	41	41	41	41	41	41	17	12	12	12	12	13	12	12	12	12	18	10	10	10	10	10	10	10	10	10	10	10	10	10	10	10	17	12	12	12	12	12	12	13	12	12	12	13	12	12	12	12	13	12	12	13	12	12	12	12	12
12	12	12	12	12	12	12	12	12	12	24	15	15	15	15	25	13	12	12	12	12	12	12	12	12	24	15	15	15	15	15	16	41	41	41	41	41	41	41	41	41	14	15	15	15	15	15	15	15	25	12	12	12	12	12	13	12	12	12	24	15	15	15	15	15	15	15	15	15	15	15	15	15	15	15	25	12	13	12	12	12	12	13	12	12	12	12	12	12	12	12	12	13	12	12	12	12	12	12	12
12	12	12	12	12	12	13	12	12	13	12	12	12	12	12	12	12	12	12	12	12	12	12	12	12	13	12	12	12	12	12	18	41	41	41	41	41	41	41	41	41	17	12	13	12	13	12	12	13	12	13	12	12	13	12	12	12	12	13	12	12	12	12	13	12	12	12	13	12	12	12	12	13	12	12	12	12	12	12	12	12	12	13	12	12	12	12	13	12	12	12	12	13	12	12	12	12	12	12	12
12	12	12	12	12	12	12	12	12	12	12	12	13	12	12	12	12	12	13	12	12	12	12	12	12	12	12	12	12	12	12	24	15	16	41	41	41	41	41	14	15	25	12	13	12	12	12	12	13	12	12	12	12	13	12	12	13	12	13	12	12	12	12	13	12	12	12	13	12	12	12	12	13	12	12	12	12	12	12	12	12	12	13	12	12	12	12	13	12	12	12	12	13	12	12	12	12	12	12	12
12	13	12	12	12	12	12	13	12	12	12	12	13	12	12	12	12	13	12	12	12	12	13	12	12	12	12	13	12	12	12	12	12	24	15	15	15	15	15	25	12	12	12	13	12	12	12	12	13	12	12	12	12	13	12	12	12	12	13	12	12	12	12	13	12	12	12	13	12	12	12	12	13	12	12	12	12	13	12	12	12	12	13	12	12	12	12	13	12	12	12	12	13	12	12	12	12	12	12	12
12	12	13	12	12	12	12	12	13	12	12	12	12	13	12	12	12	12	13	12	12	12	12	13	12	12	12	12	13	12	12	12	12	12	12	12	12	12	12	12	12	12	12	12	13	12	12	12	12	13	12	12	12	12	13	12	12	12	12	13	12	12	12	12	13	12	12	12	13	12	12	12	12	13	12	12	12	12	13	12	12	12	12	13	12	12	12	12	13	12	12	12	12	12	12	13	12	12	12	12
12	12	12	13	12	12	12	12	12	13	12	12	12	12	13	12	12	12	12	13	12	12	12	12	13	12	12	12	12	13	12	12	12	12	13	12	12	12	12	13	12	12	12	12	12	13	12	12	12	12	13	12	12	12	12	13	12	12	12	12	13	12	12	12	12	13	12	12	12	13	12	12	12	12	13	12	12	12	12	13	12	12	12	12	13	12	12	12	12	13	12	12	12	12	12	12	13	12	12	12
12	12	12	12	13	12	12	12	12	12	13	12	12	12	12	13	12	12	12	12	13	12	12	12	12	13	12	12	12	12	13	12	12	12	12	13	12	12	12	12	12	12	12	12	12	12	13	12	12	12	12	13	12	12	12	12	13	12	12	12	12	13	12	12	12	12	12	12	12	12	13	12	12	12	12	13	12	12	12	12	13	12	12	12	12	13	12	12	12	12	12	13	12	12	12	12	12	13	12	12
12	12	12	12	12	13	12	12	12	12	12	12	12	12	12	12	12	12	12	12	12	12	12	12	12	12	12	12	12	12	12	12	12	12	12	12	12	12	12	12	12	12	12	12	12	12	12	12	12	12	12	12	12	12	12	12	12	12	12	12	12	12	12	12	12	12	12	12	12	12	12	12	12	12	12	12	12	12	12	12	12	12	12	12	12	12	12	12	12	12	12	12	12	12	12	12	12	12	13	12
12	12	12	12	12	12	12	12	12	12	12	12	12	12	12	12	12	12	12	12	12	12	12	12	12	12	12	12	12	12	12	12	12	12	12	12	12	12	12	12	12	12	12	12	12	12	12	12	12	12	12	12	12	12	12	12	12	12	12	12	12	12	12	12	12	12	12	12	12	12	12	12	12	12	12	12	12	12	12	12	12	12	12	12	12	12	12	12	12	12	12	12	12	13	12	12	12	12	12	12
12	12	12	12	12	12	12	12	12	12	12	12	12	12	12	12	12	12	12	12	12	12	12	12	12	12	12	12	12	12	12	12	12	12	12	12	12	12	12	12	12	12	12	12	12	12	12	12	12	12	12	12	12	12	12	12	12	12	12	12	12	12	12	12	12	12	12	12	12	12	12	12	12	12	12	12	12	12	12	12	12	12	12	12	12	12	12	12	12	12	12	12	12	12	12	12	12	12	12	12
12	12	12	12	12	12	12	13	12	12	12	12	13	12	12	12	12	13	12	12	12	12	13	12	12	12	12	13	12	12	12	12	13	12	12	12	12	13	12	12	12	12	13	12	12	12	12	13	12	12	12	12	13	12	12	12	12	13	12	12	12	12	13	12	12	12	12	13	12	12	12	12	13	12	12	12	12	13	12	12	12	12	13	12	12	12	12	13	12	12	13	12	13	12	12	12	12	13	12	12
12	12	13	12	12	12	12	12	13	12	12	12	12	13	12	12	12	12	13	12	12	12	12	13	12	12	12	12	13	12	12	12	12	13	12	12	12	12	13	12	12	12	12	13	12	12	12	12	13	12	12	12	12	13	12	12	12	12	13	12	12	12	12	13	12	12	12	12	13	12	12	12	12	13	12	12	12	12	13	12	12	12	12	13	12	12	12	12	13	12	12	12	12	13	12	12	12	12	13	12
12	12	12	13	12	12	12	12	12	13	12	12	12	12	13	12	12	12	12	13	12	12	12	12	13	12	12	12	12	13	12	12	12	12	13	12	12	12	12	13	12	12	12	12	13	12	12	12	12	13	12	12	12	12	13	12	12	12	12	13	12	12	12	12	13	12	12	12	12	13	12	12	12	12	13	12	12	12	12	13	12	12	12	12	13	12	12	12	12	13	12	12	12	12	13	12	12	12	12	13
12	12	12	12	13	12	12	12	12	12	13	12	12	12	12	13	12	12	12	12	13	12	12	12	12	13	12	12	12	12	13	12	12	12	12	13	12	12	12	12	13	12	12	12	12	13	12	12	12	12	13	12	12	12	12	13	12	12	12	12	13	12	12	12	12	13	12	12	12	12	13	12	12	12	12	13	12	12	12	12	13	12	12	12	12	13	12	12	12	12	13	12	12	12	12	13	12	12	12	12
12	12	12	12	12	13	12	12	12	12	12	12	12	12	12	12	12	12	12	12	12	12	12	12	12	12	12	12	12	12	12	12	12	12	12	12	12	12	12	12	12	12	12	12	12	12	12	12	12	12	12	12	12	12	12	12	12	12	12	12	12	12	12	12	12	12	12	12	12	12	12	12	12	12	12	12	12	12	12	12	12	12	12	12	12	12	12	12	12	12	12	12	12	12	12	12	12	12	12	12
12	12	12	12	12	12	12	12	12	12	12	12	12	12	12	12	12	12	12	12	12	12	12	12	12	12	12	12	12	12	12	12	12	12	12	12	12	12	12	12	12	12	12	12	12	12	12	12	12	12	12	12	12	12	12	12	12	12	12	12	12	12	12	12	12	12	12	12	12	12	12	12	12	12	12	12	12	12	12	12	12	12	12	12	12	12	12	12	12	12	12	12	12	12	12	12	12	12	12	12
12	12	12	12	12	12	12	12	12	12	12	12	12	12	12	12	12	12	12	12	12	12	12	12	12	12	12	12	12	12	12	12	12	12	12	12	12	12	12	12	12	12	12	12	12	12	12	12	12	12	12	12	12	12	12	12	12	12	12	12	12	12	12	12	12	12	12	12	12	12	12	12	12	12	12	12	12	12	12	12	12	12	12	12	12	12	12	12	12	12	12	12	12	12	12	12	12	12	12	12
